{
    "maps": {
        "MAP_WIDTH": 9,
        "MAP_HEIGHT": 4,
        "map_hl": [
            [ 0, 1, 1, 1, 1, 1, 1, 1, 0 ],
            [ 0, 0, 1, 0, 0, 0, 0, 0, 0 ],
            [ 0, 0, 0, 0, 1, 0, 0, 0, 0 ],
            [ 0, 1, 1, 1, 1, 1, 1, 1, 0 ]
        ],
        "map_deploy": [
            [ 1, 1, 1, 1, 1, 1, 1, 1, 1 ],
            [ 1, 1, 1, 1, 1, 1, 1, 1, 1 ],
            [ 1, 1, 1, 1, 1, 1, 1, 1, 1 ],
            [ 1, 1, 1, 1, 1, 1, 1, 1, 1 ]
        ],
        "map_mv": [
            [ 0, 0, 0, 0, 0, 0, 0, 0, 0 ],
            [ 1, 1, 0, 1, 1, 1, 1, 1, 0 ],
            [ 0, 1, 1, 1, 0, 1, 1, 1, 1 ],
            [ 0, 0, 0, 0, 0, 0, 0, 0, 0 ]
        ],
        "map_home": [
            [ 0, 0, 0, 0, 0, 0, 0, 0, 0 ],
            [ 2, 0, 0, 0, 0, 0, 0, 0, 0 ],
            [ 0, 0, 0, 0, 0, 0, 0, 0, 1 ],
            [ 0, 0, 0, 0, 0, 0, 0, 0, 0 ]
        ]
    }
}